0	0	4	4	4	0	0
0	4	2	2	2	4	0
4	3	3	3	3	3	4
2	3	4	0	4	3	2
2	3	0	0	0	3	2
2	3	44	0	44	3	2
44	3	3	34	3	3	44
0	44	2	2	2	44	0
0	0	4	4	4	0	0