2	2	2	2	2	2	2
2	2	2	2	2	2	2
35	35	35	35	35	35	35
3	0	4	0	4	0	3
3	4	4	4	4	4	3
3	0	4	0	4	0	3
35	35	35	35	35	35	35
2	2	2	2	2	2	2
2	2	2	2	2	2	2