2	2	2	2	2	2	2
3	3	3	3	3	3	3
3	4	0	0	4	4	3
3	0	0	45	45	4	3
3	0	45	45	45	0	3
3	4	45	45	0	0	3
3	4	4	0	0	4	3
3	3	3	3	3	3	3
2	2	2	2	2	2	2