2	2	2	2	2	2	2
2	2	2	2	2	2	2
2	2	3	0	3	2	2
2	2	3	4	3	2	2
4	4	3	4	3	4	4
2	4	3	4	3	4	2
2	0	3	4	3	0	2
2	2	2	2	2	2	2
2	2	2	2	2	2	2