2	2	2	2	2	2	2
3	3	3	3	3	3	3
3	0	0	0	0	4	3
3	0	45	45	45	4	3
3	0	0	0	0	4	3
3	0	45	45	45	4	3
3	0	0	0	0	4	3
3	3	3	3	3	3	3
2	2	2	2	2	2	2