2	2	2	2	2	2	2
3	3	3	3	3	3	3
3	4	4	4	4	4	3
3	0	0	4	0	0	3
3	4	0	0	0	4	3
3	4	0	0	0	4	3
34	4	44	4	44	4	34
3	34	3	34	3	34	3
2	2	2	2	2	2	2