2	2	2	2	2	2	2
3	3	3	3	3	3	3
3	4	0	0	0	0	3
3	4	45	45	45	0	3
3	4	0	0	0	0	3
3	4	45	45	45	0	3
3	4	0	0	0	0	3
3	3	3	3	3	3	3
2	2	2	2	2	2	2