2	2	2	0	0	0	0
2	2	2	0	4	4	0
2	2	2	3	4	4	0
2	2	2	3	4	4	0
0	0	34	34	34	0	0
0	4	4	3	2	2	2
0	4	4	3	2	2	2
0	4	4	0	2	2	2
0	0	0	0	2	2	2