0	0	4	4	4	0	0
0	0	4	0	4	0	0
4	4	4	0	4	4	4
0	0	0	0	0	0	0
35	35	35	35	35	35	35
2	2	2	2	2	2	2
3	3	3	3	3	3	3
2	2	2	2	2	2	2
3	3	3	3	3	3	3