2	2	2	2	2	2	2
2	2	2	0	0	2	2
2	2	2	3	0	2	2
2	2	2	3	0	0	0
0	45	45	45	45	45	0
0	0	0	3	2	2	2
2	2	0	3	2	2	2
2	2	0	0	2	2	2
2	2	2	2	2	2	2