2	2	2	2	2	2	2
3	3	3	3	3	3	3
45	0	45	0	45	0	45
0	0	0	0	0	0	0
45	0	45	0	45	0	45
3	3	3	3	3	3	3
2	2	2	2	2	2	2
2	2	2	2	2	2	2
2	2	2	2	2	2	2