2	2	2	2	2	2	2
3	3	3	3	3	3	3
3	0	0	0	0	0	3
3	0	0	4	4	0	3
3	0	45	4	45	0	3
3	0	4	4	0	0	3
3	0	0	0	0	0	3
3	3	3	3	3	3	3
2	2	2	2	2	2	2