0	0	0	0	4	4	4
4	4	4	0	0	0	0
0	0	0	0	4	4	4
4	4	4	0	0	0	0
0	0	0	0	4	4	4
45	45	45	45	45	45	45
2	2	2	2	2	2	2
2	2	2	2	2	2	2
2	2	2	2	2	2	2