2	2	2	2	2	4	4
2	2	2	2	2	0	0
2	2	2	2	4	4	24
2	2	2	2	0	0	2
2	2	4	4	4	4	2
2	2	0	0	24	24	2
4	4	4	4	2	2	2
0	0	24	24	2	2	2
4	4	2	2	2	2	2