2	3	3	3	3	3	2
2	2	2	2	2	2	2
2	3	3	3	3	3	2
2	0	4	0	4	0	2
2	4	0	4	0	4	2
2	3	3	3	3	3	2
2	2	2	2	2	2	2
2	2	2	2	2	2	2
2	3	3	3	3	3	2