2	2	2	2	2	2	2
2	2	2	0	0	0	2
2	2	4	4	4	0	2
2	2	4	4	4	0	2
24	24	4	4	4	2	2
2	0	4	4	4	2	2
2	0	44	44	44	2	2
2	0	0	0	2	24	24
2	2	2	2	2	2	2