2	2	2	2	2	2	2
2	2	2	2	2	2	2
2	3	0	4	0	3	2
2	3	4	0	4	3	2
2	3	0	0	0	3	2
2	3	44	0	44	3	2
2	34	0	4	0	34	2
24	2	2	24	2	2	24
2	2	2	2	2	2	2