0	0	4	3	4	0	0
0	0	4	3	4	0	0
4	4	4	3	4	4	4
2	2	2	3	2	2	2
3	3	3	3	3	3	3
24	24	24	34	24	24	24
4	4	4	3	4	4	4
0	0	4	3	4	0	0
0	0	4	3	4	0	0