2	2	2	2	2	2	2
2	2	2	2	2	2	2
2	3	3	3	3	3	2
2	4	0	0	0	3	2
2	4	4	4	0	3	2
2	4	0	0	0	3	2
2	34	34	34	34	34	2
2	2	2	2	2	2	2
2	2	2	2	2	2	2