2	2	2	2	2	2	2
2	2	2	2	2	2	2
2	3	3	0	3	3	2
2	3	3	0	3	3	2
2	0	3	0	3	0	2
2	45	0	0	0	45	2
2	44	44	44	44	44	2
24	2	2	2	2	2	24
2	2	2	2	2	2	2