2	2	2	2	2	2	2
2	2	2	2	2	2	2
2	3	3	3	3	3	2
2	3	0	0	0	3	2
2	0	4	0	4	0	2
2	4	4	0	4	4	2
2	44	44	0	44	44	2
2	2	2	2	2	2	2
2	2	2	2	2	2	2