4	0	4	0	4	0	4
2	3	2	3	2	3	2
2	2	2	2	2	2	2
2	2	2	2	2	2	2
2	2	2	2	2	2	2
2	2	2	2	2	2	2
2	2	2	2	2	2	2
25	2	25	2	25	2	25
0	4	0	4	0	4	0