2	2	2	2	2	2	2
2	3	4	0	4	3	2
2	3	4	4	4	3	2
2	3	0	0	0	3	2
2	3	25	25	25	3	2
2	3	0	0	0	3	2
2	3	4	44	4	3	2
2	34	44	0	44	34	2
2	2	2	2	2	2	2