2	2	2	2	2	2	2
2	35	35	35	35	35	2
2	3	3	0	3	3	2
2	3	0	0	0	3	2
2	3	4	4	4	3	2
2	3	4	4	4	3	2
2	3	0	0	0	3	2
2	34	34	0	34	34	2
2	2	2	2	2	2	2