2	2	0	0	0	2	2
2	4	4	0	4	4	2
2	4	4	2	4	4	2
0	4	4	2	4	4	0
0	0	24	24	24	0	0
0	4	4	2	4	4	0
2	4	4	2	4	4	2
2	4	4	0	4	4	2
2	2	0	0	0	2	2