2	2	2	2	2	2	2
2	35	35	35	35	35	2
2	3	0	0	0	3	2
2	3	0	4	4	3	2
2	3	0	0	0	3	2
2	3	4	4	0	3	2
2	3	0	0	0	3	2
2	34	34	34	34	34	2
2	2	2	2	2	2	2