2	2	2	2	2	2	2
2	2	4	4	4	2	2
2	2	4	0	4	2	2
2	4	0	0	0	4	2
2	4	0	0	0	4	2
24	4	0	0	0	4	24
2	44	0	0	0	44	2
2	2	44	0	44	2	2
2	2	4	4	4	2	2