2	2	4	0	4	2	2
2	2	4	0	4	2	2
2	2	0	0	4	2	2
2	2	4	0	4	2	2
2	2	4	0	0	2	2
2	2	4	0	4	2	2
24	24	0	0	4	24	24
2	2	4	0	4	2	2
2	2	4	0	4	2	2